1111110111
100P0E0101
1C10000111
1111111111
