1111111111
100P0E0101
1C100R0111
1111111111
