111111111111111111111111111111
100100000000010000000C10001001
10000C000000011010000C00010001
100C00000000C10000001000100001
10000000C000001000111001000001
100P00000000C10000000010000011
10000000E00000000101000C000101
100000001000000000100000001001
10000000C000001000111000010001
100001000000C10000000010000011
10000000C000001000111000000101
100010000000C10000000010001001
10001000C000001000111000010001
100100000000C10000000010000011
100100000000C10000000010000101
111111111111111111111111111111
