11111111111111111111111111111111111111111
100100000000000001000000000000000C1000001
100000000C00000001101000000000000C0000001
100C0000000000000000C10000000000100000001
1000000000000000C000001000000011100000001
100P00000000C1000000000000000000001000001
100000000000E00000000100001000C0000000001
11111111111111111111111111111111111111111
