11111111111111
100P000000E001
100000000C0001
100C00001001
11111111111111
