1111111111
100P0E0101
1C100C0111
1111111111
